WWWWWWWWWWWWWWWWWWW
WNNNNNNNNWNNNNNNNNW
WNWWNWWWNWNWWWNWWNW
WNNNNNNNNNNNNNNNNNW
WNWWNWNWWWWWNWNWWNW
WNNNNWNNNWNNNWNNNNW
WWWWNWWWNWNWWWNWWWW
NNNWNWNNNNNNNWNWNNN
WWWWNWNWWWWWNWNWWWW
NNNNNNNWNNNWNNNNNNN
WWWWNWNWWWWWNWNWWWW
NNNWNWNNNNNNNWNWNNN
WWWWNWNWWWWWNWNWWWW
WNNNNNNNNWNNNNNNNNW
WNWWNWWWNWNWWWNWWNW
WNNWNNNNNSNNNNNWNNW
WWNWNWNWWWWWNWNWNWW
WNNNNWNNNWNNNWNNNNW
WNWWWWWWNWNWWWWWWNW
WNNNNNNNNNNNNNNNNNW
WWWWWWWWWWWWWWWWWWW